0,0,0,0,0,0,0,0,0,0,0,0,0,0,0,0,0
0,6,6,0,0,0,0,0,0,0,0,3,4,3,4,5,0
0,0,0,1,0,0,0,6,7,0,0,9,3,0,3,0,0
0,0,0,0,0,0,0,0,0,0,0,0,0,9,0,9,0
0,1,0,0,0,0,0,8,8,0,0,0,9,0,0,4,0
0,2,0,0,0,0,0,0,0,0,0,9,0,9,0,9,0
0,1,0,0,0,0,4,2,3,2,4,0,9,0,0,0,0
0,2,0,0,0,0,3,1,4,1,3,0,0,0,0,9,0
0,1,0,0,0,0,0,0,0,0,0,0,0,0,0,0,0
0,2,0,0,7,0,0,0,4,0,8,8,0,0,0,3,0
0,1,0,0,0,0,0,0,0,0,0,0,0,0,0,0,0
0,2,0,0,0,0,3,0,0,0,4,4,0,0,0,0,0
0,0,0,0,0,0,0,0,0,0,0,0,0,0,0,3,0
0,0,0,1,0,0,4,0,0,8,8,0,0,0,0,3,0
0,0,0,0,0,0,0,0,0,0,0,0,0,0,0,0,0
0,6,6,0,0,0,7,0,0,0,0,0,0,9,0,0,0
0,0,0,0,0,0,0,0,0,0,0,0,0,0,0,0,0
