0,0,0,0,0,0,0,0,0,0,0,0,0,0,0,0,0
0,0,0,0,0,9,9,3,5,3,9,9,0,0,4,4,0
0,0,0,0,0,9,9,0,3,0,9,9,0,8,4,4,0
0,0,0,0,0,0,0,0,0,0,0,0,0,0,8,0,0
0,0,0,0,0,2,0,0,0,0,0,4,0,0,0,0,0
0,8,8,0,2,0,9,8,8,8,9,0,4,0,8,8,0
0,1,1,0,0,9,0,0,0,0,0,9,0,0,8,8,0
0,1,1,0,0,8,0,7,6,7,0,8,0,0,2,2,0
0,1,1,0,0,8,0,6,0,6,0,8,0,0,2,2,0
0,1,1,0,0,8,0,7,6,7,0,8,0,0,2,2,0
0,1,1,0,0,9,0,0,0,0,0,9,0,0,8,8,0
0,8,8,0,3,0,9,8,8,8,9,0,1,0,8,8,0
0,0,0,0,0,3,0,0,0,0,0,1,0,0,0,0,0
0,0,8,0,0,0,0,0,0,0,0,0,0,0,0,0,0
0,4,4,8,0,9,9,0,0,0,9,9,0,0,0,0,0
0,4,4,0,0,9,9,3,0,3,9,9,0,0,0,0,0
0,0,0,0,0,0,0,0,0,0,0,0,0,0,0,0,0
