2,2,2,2,2,2,2,2,2,2,2,2,2,2,2,2,2
2,3,0,0,0,0,0,0,0,0,0,0,0,0,0,0,1
2,0,0,0,0,1,1,1,0,5,0,0,0,0,0,0,1
2,0,1,0,0,0,0,0,0,5,0,1,1,1,0,0,1
2,0,0,1,0,0,0,0,0,5,0,0,0,1,0,0,1
2,0,0,0,5,0,0,0,0,5,0,0,0,1,0,0,1
2,0,1,0,0,5,0,0,0,5,0,0,0,5,0,0,1
2,0,1,0,0,0,1,0,0,5,0,0,0,5,0,0,1
2,0,1,0,0,0,0,1,4,5,0,0,0,1,0,0,1
2,0,0,0,0,0,0,4,0,4,4,0,0,1,0,0,1
2,0,5,5,5,5,5,5,4,5,4,0,0,1,0,0,1
2,0,0,0,0,0,0,0,4,4,4,0,0,1,1,0,1
2,0,0,0,0,0,0,0,0,5,0,5,0,0,0,0,1
2,0,0,0,0,0,0,0,0,5,0,0,0,0,0,0,1
2,0,0,0,0,0,0,0,0,5,0,0,0,5,0,0,1
2,0,0,0,0,0,0,0,0,0,0,0,0,0,0,0,1
2,1,1,1,1,1,1,1,1,1,1,1,1,1,1,1,1
