0,0,0,0,0,0,0,0,0,0,0,0,0,0,0,0,0
0,0,0,0,0,9,0,0,0,0,0,9,0,0,0,0,0
0,0,0,4,0,8,3,9,0,0,0,8,0,4,0,0,0
0,0,4,0,0,3,9,0,0,0,0,9,0,0,0,0,0
0,0,0,0,0,9,0,0,0,0,0,1,0,9,9,0,0
0,0,4,0,9,9,9,0,1,3,0,0,0,9,2,0,0
0,0,0,1,0,9,0,0,0,0,0,0,0,0,0,0,0
0,0,7,0,7,0,0,0,0,0,0,9,9,0,3,7,0
0,0,0,0,0,0,0,0,0,0,2,9,2,0,0,0,0
0,0,4,0,3,1,0,0,0,0,0,0,0,9,0,7,0
0,0,0,0,0,0,0,0,0,0,0,0,9,2,0,0,0
0,0,2,0,7,0,4,7,0,4,0,0,9,0,4,0,0
0,0,0,0,0,0,7,0,6,6,0,9,9,9,2,0,0
0,0,0,0,0,0,0,0,0,0,0,0,9,0,0,0,0
0,0,0,0,0,6,4,7,0,4,0,7,0,0,0,4,0
0,0,0,0,0,0,0,0,0,0,0,7,0,0,0,0,0
0,0,0,0,0,0,0,0,0,0,0,0,0,0,0,0,0
