0,0,0,0,0,0,0,0,0,0,0,0,0,0,0,0,0
0,1,0,0,0,0,3,0,0,0,3,0,0,0,0,1,0
0,0,0,0,0,0,0,0,0,0,6,9,0,0,0,0,0
0,0,0,0,7,7,7,7,7,0,6,0,0,0,0,0,0
0,4,0,1,7,4,4,4,7,0,6,0,0,0,0,0,0
0,8,0,0,7,7,7,7,7,0,6,0,0,0,0,0,0
0,0,0,0,0,0,0,0,0,0,6,0,0,0,0,2,0
0,0,0,0,0,0,0,0,0,0,0,0,0,0,0,0,0
0,0,0,0,2,2,2,2,9,9,0,0,0,0,0,0,0
0,0,0,0,0,0,0,0,0,0,0,0,0,0,0,0,0
0,0,0,0,0,0,0,0,0,0,0,0,0,0,0,2,0
0,8,0,0,0,6,6,6,0,0,0,0,0,0,0,0,0
0,4,0,1,0,6,5,6,0,7,0,0,0,0,0,0,0
0,0,0,0,0,6,6,6,0,0,0,0,0,0,0,0,0
0,0,0,0,0,0,0,0,0,0,0,9,0,0,0,0,0
0,1,0,0,0,0,2,0,0,0,2,0,0,0,0,1,0
0,0,0,0,0,0,0,0,0,0,0,0,0,0,0,0,0
