0,0,0,0,0,0,0,0,0,0,0,0,0,0,0,0,0
0,0,4,9,4,9,4,9,4,9,4,9,4,9,4,0,0
0,1,0,0,0,0,0,0,0,0,0,0,0,0,0,3,0
0,6,0,1,0,0,9,0,0,0,9,0,0,3,0,8,0
0,1,0,0,0,8,0,4,4,4,0,8,0,0,0,3,0
0,6,0,0,0,0,0,7,7,7,0,0,0,0,0,8,0
0,1,0,0,0,0,0,0,0,0,0,0,0,0,0,3,0
0,6,0,0,0,0,0,0,9,0,0,0,0,0,0,8,0
0,1,0,0,0,0,0,9,0,9,0,0,0,0,0,3,0
0,6,0,0,0,0,0,0,9,0,0,0,0,0,0,8,0
0,1,0,0,0,0,0,0,0,0,0,0,0,0,0,3,0
0,6,0,0,0,0,0,8,5,8,0,0,0,0,0,8,0
0,1,0,0,0,0,0,8,8,8,0,0,0,0,0,3,0
0,6,0,4,0,0,0,0,0,0,0,0,0,1,0,8,0
0,1,0,0,0,0,0,0,0,0,0,0,0,0,0,3,0
0,0,2,7,2,7,2,7,2,7,2,7,2,7,2,0,0
0,0,0,0,0,0,0,0,0,0,0,0,0,0,0,0,0
