0,0,0,0,0,0,0,0,0,0,0,0,0,0,0,0,0
0,3,0,0,0,0,7,0,4,4,4,0,0,0,0,0,0
0,0,0,0,0,0,0,0,0,0,0,7,0,0,0,3,0
0,0,0,0,0,0,0,0,0,0,0,9,0,8,3,8,0
0,0,0,6,4,0,1,0,0,0,0,9,0,3,8,0,0
0,0,0,0,0,0,8,0,0,7,0,0,0,0,0,0,0
0,0,0,0,0,0,1,0,0,7,0,0,0,0,0,0,0
0,9,9,0,0,0,8,0,0,7,0,0,3,8,0,0,0
0,0,9,0,5,0,1,0,0,0,0,0,0,0,0,0,0
0,9,9,0,0,0,8,0,0,0,8,0,0,0,0,0,0
0,0,0,0,0,0,1,0,0,0,0,0,0,0,8,0,0
0,0,0,0,0,0,8,0,0,0,8,3,0,8,3,0,0
0,0,0,6,3,0,1,0,0,0,8,0,0,0,0,0,0
0,0,0,0,0,0,0,0,0,0,0,0,0,0,0,0,0
0,0,0,0,0,0,0,0,0,0,0,0,2,6,2,6,0
0,4,0,0,0,0,7,0,4,4,4,9,6,2,6,2,0
0,0,0,0,0,0,0,0,0,0,0,0,0,0,0,0,0
