0,0,0,0,0,0,0,0,0,0,0,0,0,0,0,0,0
0,0,0,2,1,0,0,7,5,7,0,0,0,0,0,0,0
0,0,0,1,2,0,0,0,7,0,0,0,0,0,0,0,0
0,0,0,0,0,0,0,0,0,0,0,0,0,0,0,0,0
0,0,0,0,4,9,0,0,0,0,0,3,0,0,0,0,0
0,0,0,0,0,0,0,0,0,0,0,0,3,0,0,0,0
0,0,0,0,0,0,0,4,9,0,0,0,0,3,0,0,0
0,3,6,0,0,6,0,0,0,0,0,0,0,0,0,6,0
0,6,0,0,0,0,0,0,0,3,4,9,0,0,0,0,0
0,0,0,0,0,4,0,6,0,0,0,0,0,0,0,0,0
0,0,0,0,7,3,0,0,0,0,0,3,4,9,0,0,0
0,0,0,0,4,7,4,0,0,6,0,0,0,0,0,0,0
0,0,0,0,0,0,0,0,7,0,0,0,0,0,0,9,0
0,0,0,0,0,0,0,0,0,6,0,0,0,0,0,0,0
0,0,0,0,0,0,0,0,0,7,6,0,0,0,4,4,0
0,0,0,0,0,6,3,7,0,0,0,7,0,0,4,4,0
0,0,0,0,0,0,0,0,0,0,0,0,0,0,0,0,0
